...|.|...
...|.|...
...|.|...
...|.|...
.{-/.\-}.
.|.e.e.|.
.|.e.e.|.
.\-}.{-/.
...|.|...
.{-/.\-}.
.|.....|.
.|.....|.
.|.....|.
.\-}.{-/.
...|.|...
...|.|...
