...|.|...
...|.|...
...|.|...
{--/.\--}
|.......|
|.......|
|.e...e.|
|.......|
|.......|
|.e...e.|
|.......|
\}.{-}.{/
.|.|.|.|.
.|.v.v.|.
.|.....|.
.\-}.{-/.
