...|.|...
...|.|...
^..|.|..^
|..|.|..|
|..|.|..|
|..|.|..|
|..|.|..|
v..|.|..v
...|.|...
->.|.|.<-
...|.|...
.{-/.\-}.
.|.e.e.|.
.\-}.{-/.
...|.|...
...|.|...
