...|.|...
...|.|...
...|.|...
...|.|...
.{-/.\-}.
.|....e|.
.|....<].
.|.....|.
.|.^.^.|.
.|.v.v.|.
.|.....|.
.|.....|.
.|.e.e.|.
.\-}.{-/.
...|.|...
...|.|...
