<--}.{-->
...|.|...
...|.|...
...|.|...
.{-/.\-}.
.|.....|.
.|.e.e.|.
.\-}.{-/.
...|.|...
.{-/.\-}.
.|.....|.
.|.....|.
.|...e.|.
.\-}.{-/.
...|.|...
...|.|...
