...|.|...
...|.|...
...|.|...
...|.|...
...|.|...
...|.|...
...|.|...
...|.|...
...|.|...
...|.|...
...|.|...
.{-/.\-}.
.|.e.e.|.
.\-}.{-/.
...|.|...
...|.|...
